SO        ./textures/blue_light.xpm

        NO    ./textures/concrete.xpm

       WE       ./textures/tech_0G.xpm

EA        ./textures/win_blue_light.xpm

F 34,22,90

C 0,30,255

                      111111111
           11111      100000001
           10001      1000000011111
        11110000111111100000001111111
        1000000000110000000000001
        1011000001110000000000001111
        10010000000000000000000000001
1111111110110000011100000000000011111
100000000011000001110111100111111
11110111111111011100000010001
11110111111111011101010010001
11000000110101011100000010001
10000000000000001100000010001
10000000000000001101010010001
1100000111010101111101111000111
11110111 1110101 111000010011
11111111 1111111 11101111111111111111111
                 10001000000000000000001
                 10001001111111100010001
        11111111110001N01000000100010001
        10000000010001111000001100010001
        10000000000000000000000000000001
        11111111111111111111111111111111
